SSS  SSWWWWWWWWWWWWWWWWWWWWWWRRWWWWWWE         S   EWWWWWWWWWWWWWWMEMMFFFFFFMMMMMMMMMMMEEEEEBFFFFFFFFFFFFF
SSS  SSWWWWWWWWWWWWWWWWWWWWWWRRRRWWWWE  S   S      EWWWWWWWWWWWWWWMEMMMMFFFFFFMMMMMMMMMEEEEEBFFFFFFFFFFFFF
SSS  SSWWWWWWWWWWWWWWWWWWWWWWRWWWWWWWE             EWWWWWWWWWWWWWWMEMMMMMFFFFFFFFFFMMMMEEEEEBFFFFFFFFFFFFF
S    SSWWWWWWWWWWWWWWWWWWWWWWRWWWWWWWEEEEEEEEEEEEEEEWWWWWWWWWWWWWWMEMFFFFFFFFFFFFFMMMMMEEEEEBFFFFFFFFFFFFF
S SSSSSWWWWWWWWWWWWWWWWWWWWWWRSSSWWWWWWWWWWTTWWWWWWWWWWWWWWWWWWWWWMEMMMMMMMMMMMEMMMMMMMEEEEEBFFFFFFFFFFFFF
S SSSSSWWWWWWWWWWWWWWWWWWWWWWRSSSWWWWWWWWWWTTWWWWWWWWWWWWWWWWWWWWWMEEEEEEEEEEEEEMMMMMMMEEEEEBFFFFFFFFFFFFF
S+SSSSSRRRRRRRRRRRRRRRRRRRRRRRSSSWWWWWWWWWWTTWWWWWWWWWWWWWWWWWWWWWMEMMMMMMMMMMMEMMMMMMMEEEEEBFFFFFFFFFFFFF
S PSSSS                      SSSSWWWWWWWWWWTTWWWWWWWWWWWWWWWWWWWWWMEMMMMMMMMMMMEMMMMMMMEEEEEBFFFFFFFFFFFFF
S?                            SSSWWWWWWWWWWTTWWWWWWWWWWWWWWWWWWWWWMEPMMMMMMMMMMEMMMMMMMEEEEEBFFFFFFFFFFFFF
SS          SSS               TTTTTTTTTTTTTTTTTTTTTTTTTTTTTTTTTTTTEEEEEEEEEEEEEEEEEEEEEEEEEEBFFFFFFFFFFFFF
SSSSSS               SSS      TTTTTTTTTTTTTTTTTTTTTTTTTTTTTTTTTTTTMMEEEMMMMMFFEEEEMMMMMEEEEEBFFFFFFFFFFFFF
SSSSSSSS             SSS      SSSWWWWWWWWWWWWWWWWWWWWWWTTWWWWWWWWWMEMMEEFFFFFFFFFFFEMMMEEEEEBFFFFFFFFFFFFF
SSSSSSSSS            SSS      SSSWWWWWWWWWWWWWWWWWWWWWWTTWWWWWWWWWMEMMEEEEMMMFFFEEEEMMMEEEEEBFFFFFFFFFFFFF
SSSSSSSSSSS          SSS      SSSWWWWWWWWWWWWWWWWWWWWWWTTWWWWWWWWWMEMMMMMEMMMFFMFFEEEMMEEEEEBFFFFFFFFFFFFF
SSSSSSSSSSSSS        SSS      SSSWWWWWWWWWWWWWWWWWWWWWWTTWWWWWWWWWMEMMMMMEEEEEEEEEEEEMMEEEEEBFFFFFFFFFFFFF
SSSSSSSSSS           SSS      SSSWWWWWWWWWWWWWWWWWWWWWWTTWWWWWWWWWMEMMMMMMMMMMMMMMMMMMMEEEEEBFFFFFFFFFFFFF
SS                   SSS      SSSWWWWWWWWWWWWWWWWWWWWWWTTWWWWWWWWWMEMMMMMMMMMMMMMMMMMMMEEEEEBFFFFFFFFFFFFF
SS                   SSSSSSSSSSSSWWWWWWWWWWWWWWWWWWWWWWTTWWWWWWWWWMEMMMMMMMMMMMMMMMMMMMEEEEEBFFFFFFFFFFFFF
SSSS                SSSSSSSSSSSSSWWWWWWWWWWWWWWWWWWWWWWTTWWWWWWWWWWWWWWWWWWWWWWWWWWWWWWWWWWWWWWWWWWWWWWWWW
SS  S    S      SS   S       ?SSSGGGGGGGGGGGGGGGGGGGGGGIIGGGGGGGGGGGGGGGGGGGGGGGGGGGGGGGGGGGGGGGGGGGGGGGGG
SS  S    S      SS   S      SSSSSIIIIIIIIIIIIIIIIIIIIIIIIIIIIIIIIIIIIIIIJJJIIIIIIIIIIIIIIIIIIIIIIIIIIIIIIJ
SS  S    S      SSSSSS      SSSSSIIIIIIIIIIIIIIIIIIIIIIIIIIIIIIIIIIIIIIIJJJIIIIIIIIIIIIIIIIIIIIIIIIIIIIIIJ
SS  S    SSSSSSSS           SSSSSIIIIIIJJJJJJJIIIIIIIIIIIIIIIIIIIIIIIIIIJJJIIIIIIIIIIIIIIIIIIIIIIIIIIIIIIJ
SS  S                 SSSSSSSSSSSIIIIIIIJJJJJJIIIIIIIIIIIIIIIIIIIIIIIIIIJJJIIIIIIIIIIIIIIIIIIIIIIIIIIIIIIJ
SS  S     SSSSSS SSS        SSSSSIIIIIIIJJJJJJIIIIIIIIIIIIIIIIIIIIIIIIIIJJJIIIIIIIIIIIIIIIIIIIIJJJJJJJJJJJ
SS  S         SS S          SSSSSIIIIIIIJJJJJJIIIIIIJIIIIIIIIIIIIIIIIIIIJJJIIIIIIIIIIIIIIIIIIIIJIIIIIIIIIJ
SS  S          S S          SSSSSIIIIIIIJJJJJJIIIIIIIIIIIIIIIIIIIIIIIIIIJJJIIIIIIIIIIIIIIIIIIIIIIIIIIIII?J
SS  S          S S          SSSSSIIIIIIIIIIIIIIIIIIIIIIIIIIIIIIIIIIIIIIIJJJIIIIIIIIIIIIIIIIIIIIJIIIIIIIIIJ
SS  S          S S          SSSSSIIIIIIIIIIIIIJJJJJJJJJJJJJJJJJJJJJJJJJJJJJIIIIIIIIIIIIIIIIIIIIJJJJJJJJJJJ
RRRRRRRRRRRRRRRRRRRRR       SSSSSIIIIIIIIIIIIIJJIIIIIIIIIIIIIIIIIIIIIIIIIIIIIIIIIIIIIIIIIIIIIIIIIIIIIIIIIJ
WWWWWWWWWWWWWWWWWWWWR       SSSSSIIIIIIIIIIIIIJJIIIIIIIIIIIIIIIIIIIIIIIIIIIIIIIIIIIIIIIIIIIIIIIIIIIIIIIIIJ
WWWWWWWWWWWWWWWWWWWWR       SSSSSIIIIIIIIIIIIIIIIIIIIIIIIIIIIIIIIIIIIIIIIIIIIIIIIIIIIIIIIIIIIIIIIIIIIIIIIJ
WWWWWWWWWWWWWWWWWWWWR       SSSSSJJJJJJJJJJJJJJJJJJJJJJJJJJJJJJJJJJJJJJJJJJJJJJJJJJJJJJJJJJJJJJJJJJJJJJJJJ